不甚感激	不胜感激
烦不甚烦	烦不胜烦
防不甚防	防不胜防
饮鸠止渴	饮鸩止渴
的嘞	得嘞
隔三差五	隔三岔五
爱答不理	爱搭不理
份量	分量
粘腻	黏腻
粘稠	黏稠
粘稠度	黏稠度
粘膜	黏膜
胃粘膜	胃黏膜
鼻粘膜	鼻黏膜
以致于	以至于
哇塞	哇噻
好象	好像
就象	就像
象是	像是
想像力	想象力
水份	水分
天份	天分
部份	部分
大部份	大部分
成份股	成分股
打版	打板
恢弘	恢宏
惟一	唯一
惟有	唯有
粘液	黏液
烘培	烘焙
甚么	什么
什麼	什么
甚麼	什么
贴子	帖子
年青	年轻
年青人	年轻人
灰常	非常
管帐	管账
记录片	纪录片
彷佛	仿佛
时侯	时候
秘钥	密钥
颤栗	战栗
寒颤	寒战
监查	监察
延申	延伸
称做	称作
畜牲	畜生
订做	定做
订制	定制
确切的说	确切地说
度过难关	渡过难关
直接了当	直截了当
作出反应	做出反应
作出贡献	做出贡献
德克萨斯州	得克萨斯州
#浆糊 糨糊？
#脚指头 脚趾头？

